{
  "id": "story_001",
  "version": 1,
  "width": 17,
  "height": 30,
  "enter": { "x": 12, "z": 28 },
  "exit": { "x": 10, "z": 1 },
  "tiles": [
    [0, 0, 0, 0, 0, 0, 0, 0, 0, 1, 1, 1, 0, 0, 0, 0, 0],
    [0, 0, 0, 0, 0, 0, 0, 0, 0, 1, 3, 1, 0, 0, 0, 0, 0],
    [0, 0, 0, 0, 0, 0, 0, 0, 0, 1, 4, 1, 0, 0, 0, 0, 0],
    [0, 0, 0, 0, 0, 0, 0, 0, 0, 1, 4, 1, 0, 0, 0, 0, 0],
    [0, 0, 0, 0, 0, 0, 0, 0, 0, 1, 4, 1, 0, 0, 0, 0, 0],
    [0, 0, 0, 0, 0, 0, 1, 1, 1, 1, 4, 1, 0, 0, 0, 0, 0],
    [0, 0, 0, 0, 0, 0, 1, 6, 4, 4, 4, 1, 0, 0, 0, 0, 0],
    [0, 0, 0, 0, 0, 0, 1, 4, 0, 1, 1, 1, 0, 0, 0, 0, 0],
    [0, 0, 0, 0, 0, 0, 1, 4, 0, 1, 1, 0, 0, 0, 0, 0, 0],
    [0, 0, 0, 0, 0, 0, 1, 4, 4, 4, 1, 0, 0, 0, 0, 0, 0],
    [0, 0, 0, 0, 0, 0, 1, 1, 1, 4, 1, 0, 0, 0, 0, 0, 0],
    [0, 0, 0, 0, 0, 0, 0, 0, 1, 4, 1, 0, 0, 0, 0, 0, 0],
    [0, 0, 0, 0, 0, 0, 0, 0, 1, 4, 1, 0, 0, 0, 0, 0, 0],
    [0, 0, 0, 0, 0, 0, 1, 1, 1, 4, 1, 1, 1, 0, 0, 0, 0],
    [0, 0, 0, 0, 0, 0, 1, 4, 4, 4, 4, 4, 1, 0, 0, 0, 0],
    [0, 0, 0, 0, 0, 0, 1, 4, 0, 4, 1, 5, 1, 0, 0, 0, 0],
    [0, 0, 0, 0, 0, 0, 1, 4, 0, 4, 1, 4, 1, 0, 0, 0, 0],
    [0, 0, 0, 0, 0, 0, 1, 4, 4, 6, 1, 4, 1, 0, 0, 0, 0],
    [0, 0, 0, 1, 1, 1, 1, 1, 1, 1, 1, 4, 1, 0, 0, 0, 0],
    [0, 0, 0, 1, 4, 4, 4, 4, 1, 1, 1, 4, 1, 0, 0, 0, 0],
    [0, 0, 0, 1, 4, 1, 1, 4, 1, 1, 1, 4, 1, 0, 0, 0, 0],
    [0, 0, 0, 1, 4, 1, 1, 4, 5, 4, 4, 4, 1, 0, 0, 0, 0],
    [1, 1, 1, 1, 4, 1, 1, 1, 1, 1, 1, 1, 1, 1, 1, 1, 1],
    [1, 4, 4, 4, 4, 4, 4, 4, 4, 4, 1, 1, 6, 4, 5, 4, 1],
    [1, 4, 0, 0, 5, 1, 1, 1, 1, 4, 4, 4, 4, 0, 0, 4, 1],
    [1, 4, 0, 0, 4, 1, 0, 0, 1, 1, 1, 1, 1, 0, 0, 4, 1],
    [1, 4, 4, 4, 4, 1, 0, 0, 0, 1, 0, 0, 0, 0, 0, 4, 1],
    [1, 1, 1, 1, 1, 1, 0, 0, 0, 1, 0, 0, 0, 0, 0, 4, 1],
    [0, 0, 0, 0, 0, 0, 0, 0, 0, 1, 0, 0, 2, 0, 0, 4, 1],
    [0, 0, 0, 0, 0, 0, 0, 0, 0, 1, 1, 1, 1, 1, 1, 1, 1]
  ],
  "meta": {
    "name": "Story 1",
    "difficulty": 1,
    "stars_total": 3,
    "dots_total": 71,
    "coins_total": 4
  }
}
