{
  "id": "story_002",
  "version": 1,
  "width": 21,
  "height": 22,
  "enter": { "x": 11, "z": 4 },
  "exit": { "x": 1, "z": 20 },
  "tiles": [
    [0, 0, 0, 0, 0, 0, 0, 0, 1, 1, 1, 1, 1, 1, 1, 1, 1, 1, 1, 1, 1],
    [0, 0, 0, 0, 0, 0, 0, 0, 1, 4, 4, 4, 4, 4, 4, 4, 4, 5, 4, 4, 1],
    [0, 0, 0, 0, 0, 0, 0, 0, 1, 0, 0, 0, 0, 0, 0, 0, 0, 0, 0, 4, 1],
    [0, 0, 0, 0, 0, 0, 0, 0, 1, 0, 0, 0, 0, 0, 7, 7, 7, 7, 7, 4, 1],
    [0, 0, 0, 0, 0, 0, 0, 0, 1, 0, 0, 2, 0, 0, 1, 0, 0, 1, 1, 4, 1],
    [0, 0, 0, 0, 0, 0, 0, 0, 1, 1, 1, 1, 1, 1, 1, 0, 0, 1, 4, 4, 1],
    [0, 0, 0, 0, 0, 0, 0, 0, 0, 0, 0, 0, 0, 0, 0, 0, 0, 1, 4, 1, 1],
    [0, 0, 0, 0, 0, 0, 0, 0, 0, 0, 0, 0, 0, 0, 1, 7, 7, 7, 4, 1, 0],
    [0, 0, 0, 0, 0, 0, 0, 0, 0, 0, 0, 0, 0, 0, 1, 0, 0, 0, 4, 1, 0],
    [0, 0, 0, 0, 0, 0, 0, 0, 0, 0, 0, 0, 0, 0, 1, 6, 4, 4, 4, 1, 0],
    [0, 0, 0, 0, 0, 0, 0, 0, 0, 0, 0, 0, 0, 0, 1, 4, 1, 1, 1, 1, 0],
    [0, 0, 0, 0, 0, 0, 0, 0, 0, 0, 0, 0, 0, 1, 1, 4, 1, 0, 0, 0, 0],
    [0, 0, 1, 1, 1, 1, 1, 1, 1, 1, 1, 1, 1, 1, 4, 4, 1, 0, 0, 0, 0],
    [1, 1, 1, 4, 4, 4, 4, 1, 1, 4, 4, 4, 1, 1, 4, 1, 1, 1, 1, 1, 0],
    [1, 0, 0, 4, 0, 0, 4, 1, 1, 4, 1, 4, 1, 1, 4, 5, 4, 4, 4, 1, 0],
    [1, 4, 4, 4, 6, 1, 4, 4, 4, 4, 1, 4, 4, 4, 5, 4, 1, 1, 4, 1, 0],
    [1, 4, 1, 1, 1, 1, 1, 1, 1, 1, 1, 1, 1, 1, 1, 4, 0, 0, 4, 1, 0],
    [1, 4, 1, 0, 0, 0, 0, 0, 0, 0, 0, 0, 0, 0, 7, 4, 0, 0, 4, 1, 0],
    [1, 4, 1, 0, 0, 0, 0, 0, 0, 0, 0, 0, 0, 0, 7, 4, 4, 4, 6, 1, 0],
    [1, 4, 1, 0, 0, 0, 0, 0, 0, 0, 0, 0, 0, 0, 1, 1, 1, 1, 1, 1, 0],
    [1, 3, 1, 0, 0, 0, 0, 0, 0, 0, 0, 0, 0, 0, 0, 0, 0, 0, 0, 0, 0],
    [1, 1, 1, 0, 0, 0, 0, 0, 0, 0, 0, 0, 0, 0, 0, 0, 0, 0, 0, 0, 0]
  ],
  "meta": {
    "name": "Story 2",
    "difficulty": 2,
    "stars_total": 3,
    "dots_total": 64,
    "coins_total": 3
  }
}
